bidsDir	/EBC/preprocessedData/TEBC-5y/BIDs_data/pilot
derivDir	/EBC/preprocessedData/TEBC-5y/derivatives/pilot
resultsDir
task	pixar
sessions	01
FD_thresh	1
DVARS_thresh	1.5
art_norm_thresh	1
art_z_thresh	3
ntmpts_exclude	.33
smoothing	5
hpf	100
detrend	no
standardize	no
events	ToM_ROIs
contrast	yes
dropvols	0
regressors	art, aCompCor
splithalf	yes
search_spaces	DMPFC, LTPJ, MMPFC, PC, RSTS, RTPJ, VMPFC
top_nvox	80
overwrite	no